{
  "id": "level3",
  "name": "Level 3",
  "legend": {
    "0": "empty",
    "2": "brick",
    "3": "window",
    "6": "door"
  },
  "colors": {
    "ceiling": "#101018",
    "floor": "#0a0a0f"
  },
  "spawn": { "x": 2.5, "y": 20.5, "rot": -1.0 },
  "rows": [
    "22222222222222222222222222222222",
    "20000000000000000000000000000002",
    "20333333333333333333333333333002",
    "20000000000000000000000000003002",
    "20333333333333333333333333303002",
    "20300000000000000000000000303002",
    "20303333333333333333333330303002",
    "20303000000000000000000300303002",
    "20303033333333333333330333303002",
    "20303030000000000000300000303002",
    "20303030333333333330333330303002",
    "20303030300000000300300030303002",
    "20303030303333330330333330303002",
    "20303030303000030303000030303002",
    "20303030303033330303333330303002",
    "20303030303030000300000300303002",
    "20303030303033333333330333303002",
    "20303030000000000000000300003002",
    "20303033333333333333333333303002",
    "20003000000000000000000000003002",
    "20333333333333333333333333333002",
    "20000000000000000000000000000002",
    "20000000000000000000000000000002",
    "22222222222222222222222222222222"
  ]
}
