{
  "id": "level2",
  "name": "Level 2",
  "legend": {
    "0": "empty",
    "2": "brick",
    "3": "window",
    "6": "door"
  },
  "audio": {
    "music": {
      "src": "/audio/music/level2/level2.wav",
      "loop": true,
      "volume": 0.5
    }
  },
  "colors": {
    "ceiling": "#0a0f14",
    "floor": "#141414"
  },
  "spawn": { "x": 3.5, "y": 3.5, "rot": 1.2 },
  "rows": [
    "22222222222222222222222222222222",
    "20000000000000000000000000000002",
    "20022222222022222222222222220002",
    "20020000002020000000000000020002",
    "20020333302020333333333333020002",
    "20020000002020000000000003020002",
    "20022222222022222222222003020002",
    "20000000000000000000002003020002",
    "20033333333333333333332003020002",
    "20030000000000000000000003020002",
    "20030333333333333333333333020002",
    "20030000000000000000000000020002",
    "20033333333333333333333333320002",
    "20000000000000000000000000320002",
    "20022222222222222222222000320002",
    "20020000000000000000002000320002",
    "20020333333333333333332000320002",
    "20020000000000000000000000320002",
    "20022222222222222222222222320002",
    "20000000000000000000000000000002",
    "20000000000000000000000000000002",
    "20000000000000000000000000000002",
    "20000000000000000000000000000002",
    "22222222222222222222222222222222"
  ]
}
