{
  "id": "level4",
  "name": "Level 4",
  "legend": {
    "0": "empty",
    "2": "brick",
    "3": "window",
    "6": "door",
    "9": "enemy"
  },
  "colors": {
    "ceiling": "#2c3a41",
    "floor": "#28231f"
  },
  "spawn": { "x": 2.5, "y": 2.5, "rot": 3.14 },
  "rows": [
    "22222222222222222222222222222222",
    "20000000000000000000000000000002",
    "20022222222222222222222922222002",
    "20020000000000000000000000002002",
    "20020222222222222222222222202002",
    "20020200000000000000000000202002",
    "20020202222222222222222220202002",
    "20000002000000000000000000002002",
    "20222202222222222222222222222002",
    "20000002000000000000000000002002",
    "20020202222222222222222220202002",
    "20020200000000000000000000202002",
    "20020222222222222222222222202002",
    "20020000000000000000000000002002",
    "20022222222222222222222222222002",
    "20000000000000000000000000000002",
    "20022222222222222222222222222002",
    "20020000000000000000000000002002",
    "20022222222222222222222222222002",
    "20000000000000000000000000000002",
    "20000000000000000000000000000002",
    "20000000000000000000000000000002",
    "20000000000000000000000000000002",
    "22222222222222222222222222222222"
  ]
}
