{
  "id": "level5",
  "name": "Level 5",
  "legend": {
    "0": "empty",
    "2": "brick",
    "3": "window",
    "6": "door"
  },
  "colors": {
    "ceiling": "#07080d",
    "floor": "#111119"
  },
  "spawn": { "x": 2.5, "y": 2.5, "rot": 0.3 },
  "rows": [
    "22222222222222222222222222222222",
    "20000000000000000000000000000002",
    "20022222222222222222222222222002",
    "20020000000000000000000000002002",
    "20020333333333333333333333332002",
    "20020000000000000000000000002002",
    "20022222222222222222222222222002",
    "20000000000000000000000000000002",
    "20022222222222222222222222222002",
    "20020000000000000000000000002002",
    "20020333333333333333333333332002",
    "20020000000000000000000000002002",
    "20022222222222222222222222222002",
    "20000000000000000000000000000002",
    "20022222222222222222222222222002",
    "20020000000000000000000000002002",
    "20020333333333333333333333332002",
    "20020000000000000000000000002002",
    "20022222222222222222222222222002",
    "20000000000000000000000000000002",
    "20000000000000000000000000000002",
    "20000000000000000000000000000002",
    "20000000000000000000000000000002",
    "22222222222222222222222222222222"
  ]
}
