{
  "id": "level5",
  "name": "Level 5",
  "legend": {
    "0": "empty",
    "2": "brick",
    "3": "window",
    "6": "door",
    "9": "enemy"
  },
  "colors": {
    "ceiling": "#243047",
    "floor": "#26211d"
  },
  "spawn": { "x": 2.5, "y": 2.5, "rot": 0.3 },
  "rows": [
    "22222222222222222222222222222222",
    "20000000000000000000000000000002",
    "20022222222222220222222922222002",
    "20020000000000020000000000002002",
    "20020222222222022222222222202002",
    "20020200000002000000000000202002",
    "20020202222202222222222220202002",
    "20000002000000000000000000002002",
    "20222202222222222222222222222002",
    "20000002000000000000000000002002",
    "20020202222202222222222220202002",
    "20020200000002000000000000202002",
    "20020222222222022222222222202002",
    "20020000000000020000000000002002",
    "20022222222222220222222222222002",
    "20000000000000000000000000000002",
    "20022222222222222222222222222002",
    "20020000000000000000000000002002",
    "20022222222222222222222222222002",
    "20000000000000000000000000000002",
    "20000000000000000000000000000002",
    "20000000000000000000000000000002",
    "20000000000000000000000000000002",
    "22222222222222222222222222222222"
  ]
}
