{
  "id": "level1",
  "name": "Level 1",
  "legend": {
    "0": "empty",
    "1": "wall",
    "2": "brick",
    "3": "window",
    "4": "stand1",
    "5": "stand2",
    "6": "door",
    "7": "gstand1",
    "8": "gstand2",
    "9": "stand3"
  },
  "spawn": { "x": 46, "y": 7, "rot": -1.5 },
  "rows": [
    "2222222222222222222222222222222222221111111111111111111122222222222222222222222222222222222222222222",
    "2000000000000000000000000000000000000001000000000000000100000000000000000000000000000000000000000002",
    "2000000000000000000000000000000000000001000000000000000100000000000000000000000000000000000000000002",
    "2000000000000000000000000000000000000001000000000000000100000000000000000000000000000000000000000002",
    "2000000000000000000000000000000000000001000000000000000100000000000000000000000000000000000000000002",
    "2000000000000000000000000000000000000001000000000000000100000000000000000000000000000000000000000002",
    "2000000000000000000000000000000000000001000000000000000100000000000000000000000000000000000000000002",
    "2000000000000000000000000000000000000001000000000000000100000000000000000000000000000000000000000002",
    "2000000000000000000000000000000000000001000000000000000100000000000000000000000000000000000000000002",
    "2000000000000000000000000000000000000001000000000000000100000000000000000000000000000000000000000002",
    "2000000000000000000000000000000000000001000000000000000100000000000000000000000000000000000000000002",
    "2000000000000000000000000000000000000001000000000000000100000000000000000000000000000000000000000002",
    "2000000000000000000000000000000000000001000000000000000100000000000000000000000000000000000000000002",
    "1111121112111111111111000000000000000001000000000000000100000000000000000011112111111111111211111111",
    "1000000100001000000001000000000000000001000000000000000100000000000000000010000001000000100000000001",
    "2000000300003000000001000000000000000001000000000000000100000000000000000020000030000030000000000002",
    "1000000100001000000001000000000000000001000000000000000100000000000000000010000001000000100000000001",
    "1111111100011111111110000000000000001111111100000000111111111110000000000100000001000000100000000002",
    "1000000100010000000001000000000000000000010000000000000100000000000000000010000001000000100000000001",
    "1000000100010000000002000000000000000000010000000000000100000000000000000020000001311110000000000001",
    "2000000300010000000001000000000000000000010000000000000100000000000000000010000001000000300000000002",
    "1000000100010000000002000000000000000000010000000000000100000000000000000011111370000001000000000001",
    "2000000100010000000001000000000000000000010000000000000100000000000000000010000001000000100000000001",
    "1000000100010000000002000000000000000000010000000000000200000000000000000010000006111111111111111111",
    "2000000400030000000001000000000000000000010000000000000100000000000000000010000001100000000000000001",
    "1000000100010000000002000000000000000000020000000000000200000000000000000020000003000000300000000002",
    "1000000100010000000001000000000000000000010000000000000100000000000000000010000001000000100000000001",
    "1111111110111111113111113111111111111110000001111112111111112111111121111201111201111112101111111111",
    "1000001000000000000000000000000000001000000000000000000100000000000000000000000000000000000000010001",
    "1000003000000000000000000000000000000000000000000000000000000000000000000000000000000000000000030001",
    "1000001000000000000000000000000000001000000000000000000100000000000000000000000000000000000000010001",
    "1111111113111111131111131111111111131111781111161111111113111161111311111311111611111111113111111111",
    "1100000000010000000001000000100000001000000000000000000100000000000000000001000000100000000000000001",
    "1100000000010000000001000000100000001000000000000000000100000000000000000001000000100000000000000001",
    "1100000000010000000001000000100000001000000000000000000100000000000000000001000000100000000000000001",
    "1100000000010000000001000000100000001000000000000000000100000000000000000001000000100000000000000001",
    "1100000000010000000001000000100000001000000000000000000100000000000000000001000000100000000000000001",
    "1100000000010000000001000000100000001000000000000000000100000000000000000001000000100000000000000001",
    "1100000000010000000001000000100000001000000000000000000100000000000000000001000000100000000000000001",
    "1100000000010000000001000000100000001000000000000000000100000000000000000001000000100000000000000001",
    "1100000000010000000001000000100000001000000000000000000100000000000000000001000000100000000000000001",
    "1111212121112121211112121211121211121110000000000000001112121211121211121112121212112121212111111111",
    "2000000000000000000000000000000000001000000000000000000100000000000000000000000000000000000000000002",
    "2000000000000000000000000000000000001000000000000000000100000000000000000000000000000000000000000002",
    "2000000000000000000000000000000000001000000000000000000100000000000000000000000000000000000000000002",
    "2000000000000000000000000000000000001000000000000000000100000000000000000000000000000000000000000002",
    "2000000000000000000000000000000000001000000000000000000100000000000000000000000000000000000000000002",
    "2222222222222222222222222222222222221111121111121111122222222222222222222222222222222222222222222222"
  ]
}
