{
  "id": "level4",
  "name": "Level 4",
  "legend": {
    "0": "empty",
    "2": "brick",
    "3": "window",
    "6": "door"
  },
  "colors": {
    "ceiling": "#0f0f12",
    "floor": "#141018"
  },
  "spawn": { "x": 16.5, "y": 12.5, "rot": 3.14 },
  "rows": [
    "22222222222222222222222222222222",
    "20000000000000000000000000000002",
    "20022222222222222222222222222002",
    "20020000000000000000000000002002",
    "20020333333333333333333333332002",
    "20020000000000000000000000002002",
    "20022222222222222222222222222002",
    "20000000000000000000000000000002",
    "20333333333333333333333333333002",
    "20000000000000000000000000003002",
    "20333333333333333333333333303002",
    "20000000000000000000000000003002",
    "20333333333333333333333333303002",
    "20000000000000000000000000003002",
    "20333333333333333333333333303002",
    "20000000000000000000000000003002",
    "20333333333333333333333333333002",
    "20000000000000000000000000000002",
    "20022222222222222222222222222002",
    "20020000000000000000000000002002",
    "20022222222222222222222222222002",
    "20000000000000000000000000000002",
    "20000000000000000000000000000002",
    "22222222222222222222222222222222"
  ]
}
