{
  "id": "level3",
  "name": "Level 3",
  "legend": {
    "0": "empty",
    "2": "brick",
    "3": "window",
    "6": "door"
  },
  "colors": {
    "ceiling": "#30314a",
    "floor": "#252022"
  },
  "spawn": { "x": 2.5, "y": 2.5, "rot": -1.0 },
  "rows": [
    "22222222222222222222222222222222",
    "20000000000000000000000000000002",
    "20022222202222222222220222222002",
    "20020000002000000000002000002002",
    "20020222222022222222222022202002",
    "20020200000020000000000000202002",
    "20020202222220222222222220202002",
    "20000002000000000000000000002002",
    "20222222222222220222222222222002",
    "20000000000000020000000000000002",
    "20022222222222022222222222222002",
    "20020000000002000000000000002002",
    "20020222222202222222222222202002",
    "20020200000000000000000000202002",
    "20020202222222222222222220202002",
    "20000002000000000000000000002002",
    "20222202222222222222222222222002",
    "20000000000000000000000000000002",
    "20022222222222222222222222222002",
    "20020000000000000000000000002002",
    "20022222222222222222222222222002",
    "20000000000000000000000000000002",
    "20000000000000000000000000000002",
    "22222222222222222222222222222222"
  ]
}
