{
  "id": "level1",
  "name": "Level 1",
  "legend": {
    "0": "empty",
    "2": "brick",
    "3": "window",
    "6": "door"
  },
  "audio": {
    "music": {
      "src": "/audio/music/level1/level1.wav",
      "loop": true,
      "volume": 0.5
    }
  },
  "colors": {
    "ceiling": "#2e3552",
    "floor": "#2b2623"
  },
  "spawn": { "x": 2.5, "y": 2.5, "rot": 0 },
  "rows": [
    "22222222222222222222222222222222",
    "20000000000000000000000000000002",
    "20022202222222202222222202222002",
    "20020002000000002000000002002002",
    "20020002022222002022222002002002",
    "20020002020002000020002000002002",
    "20020002020002222220002222222002",
    "20020000020000000000000000002002",
    "20022222022222202222222222002002",
    "20000002000000202000000002000002",
    "20022202222220202222222002222202",
    "20020002000000200000002000000202",
    "20020002022222222222222022220202",
    "20020000020000000000000020000202",
    "20022222022222022222222022220202",
    "20000002000002000000002000000202",
    "20222202222202022222002222222202",
    "20000000000000020000000000000002",
    "20022222222222022222222222222002",
    "20020000000000000000000000002002",
    "20022222222222222222222222222002",
    "20000000000000000000000000000002",
    "20000000000000000000000000000002",
    "22222222222222222222222222222222"
  ]
}
