{
  "id": "level2",
  "name": "Level 2 — Pool Rooms",
  "legend": {
    "0": "empty",
    "1": "wall",
    "3": "window",
    "4": "stand",
    "6": "door"
  },
  "audio": {
    "music": {
      "src": "/audio/music/level_2.wav",
      "loop": true,
      "volume": 0.5
    }
  },
  "colors": {
    "ceiling": "#bcd4d8",
    "floor": "#3f6c84"
  },
  "spawn": {
    "x": 4.5,
    "y": 1.5,
    "rot": 1.2
  },
  "rows": [
    "11111111111111111111111111111111111111111111111111111111111111111111111111111111111111111111111111111",
    "10100000000010000000000010000000100010000010000000000010100000001000100000001000000010000000100010001",
    "10111011101060111611101010101110111010101010111110111010101011101011101011101010111610101110101010101",
    "10000010001010001000101010101000000010101010001010100010001010000000001000101010100010101000101000101",
    "11111010111011101010101110101116101110101111001010101111111010111110111110100010101010101011101111101",
    "10001010100000101010100000100000100000100000100010100010000010000010100010101010001010101000000000001",
    "10111010311111101110111111111110111011111010111010111010111111111011101010101110113000000110000000001",
    "10100010100000000000000000001060001010000010100010100000100010001000001000100000001000000010000000001",
    "10101110101111111111111111101011101010111111101110161161101110101111113111111611106000000010000000001",
    "10101000000000000000100000100000100010000010001000100000101000100000000000100000101000000010000000001",
    "10101011000000111110101110161110111116101010111011101110101011311111111110101011101000000031101110101",
    "10001000000000001010006000100000001000101000101000100010000000000000000010001010001000000010000000101",
    "10111110000000101011111011111111111010111016101110161010000000000011111011111010111010101011111111101",
    "10000010100010001010000010001000000010001000000000001010000000000010001000001000100010101000101000101",
    "11111010101110111010111110101011111611101111111110111010000000000010111111101116101111101110101010101",
    "10000010101000100000100000100010000010100000001000100010000000000000000000000000000000000010100010001",
    "10111130101011101111101111111110101010111111101011101110000000000000000001000000111111113110101111311",
    "10001010001010100010001000001000101000000010001010006000000000000000000000000000001000001000100000101",
    "11101010111010111010161011101110101111111110111010111011111010000000000001000000101011101011111110101",
    "10001000101010001010000000100010100000000010100010101000001000000000000000000000100010101000100010101",
    "10111610101010111011113116111011111011110010111010101111101011611111101110000000111610101110101110101",
    "10100010001010100010001000001000001010001010100010600000000000000010001010000000000010001000101000101",
    "10101010111010101110101011101110106010101010101110100000000011111010111011000000111110111011101011101",
    "10001010100010100010100010100010101010100010100000000000000000001010100010000000000000101000101010001",
    "11111011101110111010111110111011101010111010111111110000000010101010111010000000111111101110101011101",
    "10001010001000000010001000001000101010101010000000000000000010101010100010000000000000001000100010001",
    "10101010111011161110101110111110101110101011111111110000000011101010101011000000111111101011101110101",
    "10101010101010001010100010000000100010101010000000000000000000001000101000101000100000000004000000101",
    "10101010101010106010111011111110111010101011101111101011101111111111101111101111100000000000001131101",
    "10101010100000101010101000000010000010100010001000101000100000000000001000001000000000000000000010001",
    "10111010111111101010101111311011111110100110111010111010113111111110111011111011110400000000001011111",
    "10100010000010101010100000101000001000100000100010000010001000000010001000001000100000000000006000001",
    "10101110111010101010101110601111101011111011101111101110101011111011101111101110100000000000001111101",
    "10101000001010001010101000100000101010001010001000100010101000101000100010001010000010000010001000001",
    "10101111111010101010101011111011101010101110111010111011101110101110101010111011111010111011101011111",
    "10100000000010001000001000000010001000100000001010101000001000001000101010101000001010001000101000001",
    "10113111111110111110111111101110111011111111111010101110111011111011101010101011101011101110101111101",
    "10001000000010000010001000001000000010000000100010101000100010100010000010101000100010001000101000001",
    "10101011111011111010111011111011101110111110101110101011101110101111111010101110111110111110111011101",
    "10100010000010001010000000101010000010000010001000101010001000100000100010100010100010000010000010001",
    "10111110111111101011111110101011111111101111101011101010111110111110101110111010101010161011111110111",
    "10100010001000001010001000001060000000001000101010000010100000100000100010001000101010100010000010101",
    "10111011101011111010101111106010111131111010111011111110101111101111101011101111301011101130111010101",
    "10001000101000001000100010001010100010001010001010000000600000100000001000101000101000101010101010001",
    "10101110101001101111111010111010101010111011101000111111111110111110111010101010101110101010101011101",
    "10101000101010001000001010001010001000100010101010100000000000000010100010100010101010001010001000101",
    "10101011101610101011101010101011101111101110101010111011111110111110101111301010101011111010101110101",
    "10101000100010101000101000101010001000101010001010001000001010100000101000100010001000100000101000101",
    "11101010111010101110101111101010111010101010111011101111101010101131301010111110111010111010101010101",
    "10001010100010100010100010001000000010001010001000001000101000100010100010000000001010000010100010001",
    "10111110101110111010101110111011101111111011101110111010000000000010101111111011101010111111111011111",
    "10100000101000100000101000100010001000001000100010001010000000000010001000000010101010100000100010001",
    "10111011101010101000000001101110110011101010111011101010000000000111111016111110101010101110101010101",
    "10001000101010101000000000001010000010001010101000100010000000000000001010100010001010100010001010101",
    "10101110101110111000000000111011111110111010101110110110000000000011101010101010111011111010101010101",
    "10600010000000100000000000000000000010100010000010000000004000000010000010001000100010000010001000101",
    "10111011111111101000000401111111111010101131111011111110000000000011111111111110101010111111111610101",
    "10001000100000001000000000000000100010100000101010000010000000000000000010000010101010000000600010101",
    "11101110101111111000000001111110100110111100100000000000000000000111111010111010101011111110101011301",
    "10006010100000100000000000001010101000100000100000000000101000000010001000001010101010100000101000101",
    "10111010111110101000000000101010111011101111100000000000101111111110101111113010101010101111101110101",
    "10000010001000101000000000100010000000001000000000000000001000000000100000001010101000100000001000101",
    "11111111101011101000000000111011111111101010100000000000111011111111111111101010101611111111111011101",
    "10000000001010001010001010001000000000001010040000000000000010100000001000100010001000000010100010001",
    "10111111111011101011101011101011111111111011100000000000111110101011101010111011111011101010101110101",
    "10000000001000100000101010101010001000000060100000000000100000001010101010001010000000101010100000101",
    "10101111101110161110101010101110101011111110100000000000111111111010101010111010116111101010111111101",
    "10100000100010100010101000100000101000000010000000000000001000100010001010001010000010001000000010001",
    "11101110101110100000000000000001101111111011100004000000101010101110111010101011101110113111111110111",
    "10001000001000100004000000000000000010001010000010000000100010100010000010100010101000100000100000101",
    "10101111161011100000000000400001111011101010111010111011111110101011111010111110101011101110101111101",
    "10101000000010100000000000000000001000001000101010001000000010101000000010600000101000001010100000101",
    "10111011111110101111311000000000111111101161101011111110101010101111111010101110101111111010111110101",
    "10100010000000101000100000000000000000100000101000000010101010101000001000101010101000000010000010001",
    "10101110101111101011101000000001111016111110101111111010101010111011101110101010101011111010111111101",
    "10101000100000001010001000000000000010000000100000101000101010001010100010001000100010000010000000101",
    "10101000000011111010101000000000111010111111101110101110101031101010111011101111111100111111111010101",
    "10100000000010000010001000000000001010001000001000600060101010101000101000100000100000100000000010101",
    "10111000000011111011101000000001101131101111101110111010101010101110103110311010101111101111111116101",
    "10001000000010000000100000000000101000000000100010000060001000100010101000100010100010100000000000001",
    "11101000004010111011111010111110101011111110111011113111111110111010101011101110111010111111111111111",
    "10001000000000100000000010000010100010000010000010001000001000001000001000100010000010100000000000001",
    "10111000000011301111111111111010111110161011111110101011101011111111111110111011111110001111111011101",
    "10000000000000100000100000100010000010101000001000101010001010000000100000101010000000100000001000101",
    "10111000000010111110111010101111111010101111101011101010111010111110101110106011111010101010101110101",
    "10001000000010000000100010100010001010100000100010100010000010101000101000001000001010101010100010101",
    "11000000000011111111101131111010111010111010111110111111111110101010101111111111100010100010011010101",
    "10000000000000101000001000000010001010000000000000000010001000100000001000000000001010100000000000101",
    "10000000000110101010111011111111101011111100000000001010101011111110111011111111111610100000000000111",
    "10000000001000101010001000100000101010000000000000001000101000001000100010001000000010100000000000001",
    "10000000001011101011101110101110101010111100000000001111101616103111101110101111101010100000000001101",
    "10000000001010100010000010100010001000100000000000000000101000101000101000101000101000100000000000001",
    "10000000001010101110111010111011111111101010101010101111101110101010101011106010101111100000000000111",
    "10000040000010001000106010001010000000001010101010101000100000100010100060001010100000000000000000001",
    "11000000001611111011101011101010113111111010111010101010111110111110161110111010101111100000000001101",
    "10000000000010000010000000101000001000000010001010101010000010000010001000100010100000100000000000001",
    "10000000001010110111113110101111010011311011101010101010101011111011101011111010111011100000000001101",
    "10000000001000100010001000101000000010100010101010100010101000001010101000600010001010000000000010001",
    "10111011101111101010101111101011111110101110101010101110111011101010101110101111101110111111111110111",
    "10000000100000001000100000000010000000000000100000100010000000100000100000001000000000100000000000001",
    "11111111111111111111111111111111111111111111111111111111111111111111111111111111111111111111111111111"
  ]
}
