{
  "id": "level4",
  "name": "Level 4",
  "legend": {
    "0": "empty",
    "1": "wall",
    "3": "window",
    "4": "stand",
    "6": "door"
  },
  "colors": {
    "ceiling": "#2c3a41",
    "floor": "#28231f"
  },
  "spawn": {
    "x": 2.5,
    "y": 2.5,
    "rot": 3.14
  },
  "rows": [
    "11111111111111111111111111111111",
    "10000000000000000000000000000001",
    "10016111111411111111411111111001",
    "10010000000000000000000000001001",
    "10010111111111111111111611101001",
    "10010100000000000000000000401001",
    "10010101111111111611146110104001",
    "10000001000000000000000000001001",
    "10116101114111111111141414111001",
    "10000001000000000000000000001001",
    "10060101111141611111161140101001",
    "10010100000000000000000000101001",
    "10010116111111111111611111401001",
    "10010000000000000000000000001001",
    "10011116114461111111111111111001",
    "10000000000000000000000000000001",
    "10011611161114141111114111411001",
    "10010000000000000000000000001001",
    "10041114111116111111411111111001",
    "10000000000000000000000000000001",
    "10000000000000000000000000000001",
    "10000000000000000000000000000001",
    "10000000000000000000000000000001",
    "11111111111111111111111111111111"
  ]
}
