{
  "id": "level2",
  "name": "Level 2",
  "legend": {
    "0": "empty",
    "1": "wall",
    "3": "window",
    "4": "stand",
    "6": "door"
  },
  "audio": {
    "music": {
      "src": "/audio/music/level_2.wav",
      "loop": true,
      "volume": 0.5
    }
  },
  "colors": {
    "ceiling": "#26364a",
    "floor": "#2a2420"
  },
  "spawn": {
    "x": 2.5,
    "y": 2.5,
    "rot": 1.2
  },
  "rows": [
    "11111111111111111111111111111111",
    "10000000000000000000000000000001",
    "10016111111411110111411111111001",
    "10010000000000010000000000001001",
    "10010111111111011111111611101001",
    "10010100000006000000000000401001",
    "10010101111101111611146110104001",
    "10000001000000000000000000001001",
    "10116101114111111111141414111001",
    "10000000000000000000000000000001",
    "10061141111141610111161141141001",
    "10010000000000010000000000001001",
    "10010116111111011111611111401001",
    "10010100000001000000000000101001",
    "10010106114401111111111110101001",
    "10000001000000000000000000004001",
    "10111601161114141111114111411001",
    "10000000000000000000000000000001",
    "10041114111116111111411111111001",
    "10040000000000000000000000004001",
    "10011114611111411111411461161001",
    "10000000000000000000000000000001",
    "10000000000000000000000000000001",
    "11111111111111111111111111111111"
  ]
}
