{
  "id": "level3",
  "name": "Level 3 — Office After Hours",
  "legend": {
    "0": "empty",
    "1": "wall",
    "3": "window",
    "4": "stand",
    "6": "door"
  },
  "audio": {
    "music": {
      "src": "/audio/music/level_3.wav",
      "loop": true,
      "volume": 0.5
    }
  },
  "colors": {
    "ceiling": "#d8d2a8",
    "floor": "#5a4630"
  },
  "spawn": {
    "x": 2.5,
    "y": 1.5,
    "rot": -0.6
  },
  "rows": [
    "11111111111111111111111111111111111111111111111111111111111111111111111111111111111111111111111111111",
    "10000000100000000010001000000000000000100000100010000010000000000010000010000000000000000000100000001",
    "11111110101110111011101011111110111110111010111010101010111111101110101110111111111011111110111011101",
    "10001000101060001000100000001010000010000010001000101010100000100000101000101000000010000010000000001",
    "10101011101011101110111111101011111011111111101011101010111010111111101011101011111110111011111000011",
    "10101010000010100010000000100010001000100010001010001010001010000010000000000000001000100010000000401",
    "11101011111000011011111110116110101110101110111110113011101111611010100000000011101011101110111000001",
    "10001000001000001010000010000010100000100010100000101010001000000010100000000000101000100000100000101",
    "10111111101000001010111011111010111161101010101111101010111011111010100000000010101110111111111010101",
    "10000000001040001010101000100010001000001010001000001010100000100010101010001010100000000000000010001",
    "10111111111000011010101110101110101016111016113010101010101110161110111016101010111111111111111110111",
    "10001010000000001010100010001000101000001000001010101010100010000010100010001010000000000010000010001",
    "11100010111000001010101011111011101611101110101010111010101111111010101130111000001111111000111011101",
    "10001000100000001010001010000000100000100000101010000010101000000010000010100000000000100000100000001",
    "10111011101000011011111011111111101110101111111011111130101010000011111010101100001011101111113111101",
    "10100000100000001000000010001000101000101000000000000010101000000010001000100000001000100010001000101",
    "10111110000000001110111010101010111011101011111111111010101100000010101110111000001110100110101011101",
    "10100010000010100010001000100010100010001000000000100010101000000000001000100000000010001000101000101",
    "10101010000010111011101111111110101111101111111110601010101000000000001111101100001011111011101110101",
    "10001000000010100000100000601000101000000000600010101010101000000000000000100000001010000010100010001",
    "11111110101011101110111110100011101010111611101010101110111000000000001110101000001010111110111011101",
    "10000010601000001010001010100000001010001000001000100000100000000000001000001000000010100000001000101",
    "10101110101131111011101010111111111111101011113111101111101000000000041110111111611110101111101110101",
    "10101000100010001000000010000000001000100010000000001000001000000000000010100010000000101010001010101",
    "10101011101110000001111111111011101010101111101110101110111000000000001011101010111111101010101010101",
    "10101000101000000000000000001010001010100000100010100000001000000000000000001000100010000060100000101",
    "10101110101011000000111111101110101010101110111011101111101111111010101131111111101011111110101110101",
    "10101000100000000000000000100000101010100010001000101000100000100010100010000000101000100010101000101",
    "10111011111111000400111110111111111010101011101010101010111110101131101010111010101110101010111011301",
    "10000010000000000000001000100000000010101010001010001010000010001000600000000010001010101000100010101",
    "10111111101111000001111010101111111110101010111011111011111010111010100000000011111010101111101110601",
    "10100000100010001000100010100000000010001000001000101010000010000010100000000010000000100000001000101",
    "10101110111010111110101110111111111011101111101110101010111110111110110000000110111111100000000000101",
    "10001000100010100010101004100000001000100000101000000010100000100010000000040010000000000000000000101",
    "11111000001110101010101110101011101110111110101111101010111110101031100000000016101111110000000000101",
    "10001000000010001010100014001000101000100010100010001010000010101010001010001010001000000000000000101",
    "10001000001011011010101010111110111011101010161011101011111011101010111010111010113011111111101011101",
    "10100000001000001000101000000010000010001010100000101010001000001010101000100010601010000000001010001",
    "10111000001111101110111011111110111111113010111110111010101111111010101110101110101011111611101010111",
    "10001000000000000010001010000010100000001010100010000010101000100010100010101010101000000000101010001",
    "11101000000000001011101110111010101610101010101011111110101110101110101010101010101111111110111011101",
    "10001000000000000010000000101010101000100010001000101000000000101000101000101010100000000010001010001",
    "10111000000000001110111111101010111011111011111110101000000000101110111110101010101011111011001010111",
    "10100000000000001000100000100010000060000000000010100000000000100000000010101010101010100010001010001",
    "10101100000000001011101110111011111110111111111110111100000000111011111011101010111010101130111011101",
    "10001000000000000000101010001000000010000010000000100000100010001000001010001010000010001010100000101",
    "10111011101110101110101011101111111011111110111111101110101010101111101010111011111110111010101111101",
    "10100000100010100010101000100000101000100000101000040010101000100000101000100000100000100010100010001",
    "10111110111000111011101010111110101110101131101011111010101111101110101111101011101111111010101010111",
    "10001010601000101000001010000010100060100010001010001010101000100060101000100000000000000010101010101",
    "11101010101111101111111100101110101010101010101010101010106010111010101110101111111111101110101010101",
    "10001010100000000000000000101000101010101010101000101010101010001010100010000010000010001000101000001",
    "10011010111011111111111111111011101010111010101110111010101010101010111016111110111010111010111111111",
    "10001000001010000000000000001010001010000010100010100010106010101010100010000060101010101010100010001",
    "11101111101010111111113111101010101111111111111010101110101110101011101110111010101010101011101010101",
    "10100000100010000000001000100060100000000000001010101000101000101000101000100010100010101000001000101",
    "10110110111000111111101010111110111010111111101010101000001011101110101110101130101110101111111111101",
    "10000010100000100010001010100000100010100010001000101000000010101010001000100010101000000000100010001",
    "10111100111110101110111010111110101110101010111111101000001110101011111011111010101111111110111010111",
    "10000000100000001000100010000010100010101010000000001000000000101000000010001010100010001000000010001",
    "10111161101011101011101031111010111010101011111010111000001110101110111110111010111010111011111011101",
    "10100000001010001010001010001010001010101000001000100000001010100000100000100010001010000010001010001",
    "10101011111011111010113011101011101011101111101110111131111010111111111000101111101010111010101110101",
    "10101060001000001010001000101000101000100010100010100010001000100000001010101000001010000010100010601",
    "10111010111111101011611110101110101110111010111011101010113016101110101110101010111001111110111010101",
    "10001010001000100010001000101000101000100010001010001010001010101000100000101010100000000010000000101",
    "11101011101010111110101011301011311011101131101010111011101010101011101111101010111111111010100111301",
    "10101000101010001000101010100010000010001000001000001000101010001000101000101010001000001010100000101",
    "10101110101011101010101010101111101010111010101131111110101011111010111010101111101011111010111110111",
    "10100000100000101010100010100000001010100000100010000000101010001010100010001000001010000010100010001",
    "10111116101111101010161110111111111010111110111010111111101010101110101111111011111010111110101111101",
    "10001000101000001010000010000000001010000010101000000000101000100000101000000010000010100010001000001",
    "10101010101011111011111011101111111011111010101011111110001111111110101110111110101110101111101011101",
    "10101010001010000010001000101000100060001000100000100010101000100000100000100000101000100000001010001",
    "10101011111010111110101110101010100110111111101110101010101010101111111111101011111011111111111011101",
    "10101010001000000000100000101010001000001000001000101010100010001000100000101010001000100010001000101",
    "11101010111000000000111111101011111110101011101011101110101111111010601010101110101110101010101110101",
    "10001010100000000000000000100000000010100010001010001000100000100000101010001000100010001000101000101",
    "10113010101000000000111110111111111010111110111010111011111610111010111011101011111011111116101011301",
    "10001000101000000400000010000010001010001010100010001000100010000010000010001010001000000000100010101",
    "10101110101011111111101111111010111011101010101110101110101011161011011110111016101111161110111110101",
    "10100000100010000000101000000060001010100010101000100010001010100010000010100010006000000010000000101",
    "10111111101110111110101011111110101010101110101111101011111010101110161011101110101011311010111110101",
    "10001000100010000010101010000010100010001000100000001060100010001000101010001000101010100060101000101",
    "11111010161011111010101010111110111111111010113111111010101130111001101010111011111010101110101011101",
    "10000010001000006010001010100010100000000010001000001010100010100010001010000010000010000010001010001",
    "10111111101111101011101010101010111010111110001011001010111010101110111011101110111116111011111010111",
    "10000010100000101010106010001000600010100010001010001010001010101000001010001000100000100000000010101",
    "10111010161110101010101010111111101011101031111010101011100011101111101010111010601110111111111010101",
    "10001010000000100010101010000010001060001010001010101000101000100000001000100010101010000000001010101",
    "11611010111111111110101031111010101110111010101010101110101110111111101111301111101000000000000010101",
    "10000010000000001000001010100010100000000000000010100010001000101000100010100000000000000000000010001",
    "10111111101110101011111010101111100000000000001110101116101010101010111000101111111100000000000011101",
    "10100000000000101010000010000000000000000000000000101000001010001010000010000000100004000000000000101",
    "10101111113111101110111110111111100000000000001011111011110010111011111110110011101100000000000011101",
    "10101000001000000000100010100010101010101010001010000010100010100010000010001010001000000000000010001",
    "10101011101111111111101011101010101010111011101010111110101011101111101010101110111110101110101110111",
    "10101010100010001000101010001010000010000000101010100000101010001000001010100010000010001000100000101",
    "10111010111010101010101010111011111111111110101110101110101110111110111011111011111011111011111111101",
    "10000000001000000010001000001000000000000000100000001000100000000000100000000000001000000000000000001",
    "11111111111111111111111111111111111111111111111111111111111111111111111111111111111111111111111111111"
  ]
}
