{
  "id": "level1",
  "name": "Level 1",
  "legend": {
    "0": "empty",
    "1": "wall",
    "3": "window",
    "4": "stand",
    "6": "door"
  },
  "audio": {
    "music": {
      "src": "/audio/music/level_1.wav",
      "loop": true,
      "volume": 0.5
    }
  },
  "colors": {
    "ceiling": "#2e3552",
    "floor": "#2b2623"
  },
  "spawn": {
    "x": 2.5,
    "y": 2.5,
    "rot": 0
  },
  "rows": [
    "11111111111111111111111111111111",
    "10000000000000000000000000000001",
    "10016101111411101111411101111001",
    "10010001000000004000000001001001",
    "10010001011111001011111001001001",
    "10010006010006000010001000001001",
    "10010001010001111610006111144001",
    "10010000010000000000000000001001",
    "10016111014111101111141414001001",
    "10000001000000104000000001000001",
    "10061101111140601111161001141101",
    "10010001000000400000001000000101",
    "10010006011111111111611011410101",
    "10010000060000000000000010000101",
    "10011116014461011111111011110401",
    "10000001000001000000001000000101",
    "10111601161104041111004111411101",
    "10000000000000010000000000000001",
    "10041114111116011111411111111001",
    "10040000000000000000000000004001",
    "10011114611111411111411461161001",
    "10000000000000000000000000000001",
    "10000000000000000000000000000001",
    "11111111111111111111111111111111"
  ]
}
