{
  "id": "level4",
  "name": "Level 4 — Concrete",
  "legend": {
    "0": "empty",
    "1": "wall",
    "3": "window",
    "4": "stand",
    "6": "door"
  },
  "audio": {
    "music": {
      "src": "/audio/music/level_4.wav",
      "loop": true,
      "volume": 0.5
    }
  },
  "colors": {
    "ceiling": "#3a4350",
    "floor": "#2f2f33"
  },
  "spawn": {
    "x": 2.5,
    "y": 1.5,
    "rot": 2.4
  },
  "rows": [
    "11111111111111111111111111111111111111111111111111111111111111111111111111111111111111111111111111111",
    "10000010000010000010000000100000100000000010001000000000100000000000100000001000000010000000000010001",
    "11111010111011101010111110101011101111101010101011111100111011111110111010101011111011111011111011101",
    "10001000101000001010001000101000000000101000000010000010000010000010001010101000100000000010001000101",
    "11101111301111111011101111101111111111103111111111111011111111101111101110101110111111111110101110101",
    "10001000101000006000100000101000001000001000000000000000100000001000101000100060001000100000100010001",
    "10100010101011101110111010101011101011161011111111111110101011111010101011101011101011101110111031101",
    "10100010100010100010001010101000101000001000000000001010101010001010100000000000001000001010101010001",
    "10111110101110101011101010101111101161103111101111101010101010101010111000000000001111101010101010111",
    "10001000100000101000106010100000000000101000100010001010101000100010000000000000001000101010100010001",
    "11101011111111101011101010111111111011100010111010111010103111111110111000000000001010101010101111101",
    "10001010000000001010001010001000000060001010100010101000101000000000101000000000001010100010100000101",
    "10111010111131111010111111101011111610111010111110101011101011101111301000000000001010000000101111101",
    "10100010000010000010000010001010000010000010100000600010001010001000100000000000000010000000101000001",
    "10111011111011111011111010111010111011111110101111101110111010111010111000000000001111000000111011111",
    "10001000000060001000100010100010101010001000100000100060101010001010000000000000000010000000100010001",
    "10101100000010101111101110101110100010111011301110111110101011111011111000000000001011000000101110101",
    "10101000000000100000001000000000101010100010101000100000001010000010000000000000001010000000101000601",
    "11101000000011111111111010116111101010101110101011101111111010111100000000000116111010040040101010101",
    "10001000000010000000001010000000001010100010001000001000000010001000000000000000000010000000600010001",
    "10111000000010111111101010101111111010111010111111111010111111101000000000000011111110000040111110111",
    "10100000000000100000100010101000000000001010001000001010100000001000000000000010001010000000000010001",
    "10101100000011101110111010113011111111111011101011111011100000000011101010111010101000000001111111101",
    "10101000000000001000001060001000100010000010101000001010000000000000000010100010100000000000100000101",
    "10101400000011111011101010101110101010111110101011101010100000001110111110101110111000000010101010101",
    "10601000000000100010001010100000001010100010001000101000100000000010000000100010100000000010000060101",
    "10101000000010601110111011111111111010101010111011101111100000001011101111111010111010111016111110101",
    "10100000000010100010001000000000001010101010001010001000000000000010001000000010001010001010001000101",
    "10111111111010111010101111111111101110101111101010101011100000001010101010111110101111001010101010101",
    "10000010000010001000100010000000100000100010001010101010001000100010101010100000100000106010100010101",
    "10111010101111101110111010111010111111101010111010111010101110101110101010111011111011101110111110101",
    "10001010100000100010100010100010100000001010001010001010600000101000101010001000001000000000100010101",
    "10101110111110311010001110101130111111011011101011101010110110311011101011103111101111116111101011101",
    "10100010000010100010101000100010000000000010001000100010000060100010000010101000101000000000001010001",
    "10111011111010101110101011111010111111161110113110111111111011101110111110101011101011111111111010111",
    "10101000001010001010101000101010100000000000100010100010000010001000000000601000101010000000001010001",
    "10101110161011111010101110101011101111311111101010101010111110111111611110101010101011111110111011101",
    "10600010000010000010100010001000101000100000001010001010000010000010001000101010006010000010100000101",
    "10110011311110101010111011101110101010101111101111111011101011111011101011101110111010011010101011101",
    "10001000100010101010101010101000101010001000100010001000101000001000100000100010001010001010101010001",
    "11101010101010101110101010101011101011111011111010101110101011101110111111101011111010101010101110111",
    "10001010101000100010100000101010001010001000001000100010101010100010000000101000100010101000101000101",
    "10111010101111111010111111101010111010101100000000011010111010111011111110101110101111101110101011101",
    "10100010100010000010000000001000100010100000000000000010000010000010000010100010600010001000106000001",
    "10101011111010111111111111111111101110111100000000011111111110111110101010111010111010111011101111101",
    "10101010000010100000000010001000001000001000000000000000000010100000101010100010000010001010001000101",
    "10101130111110101111101011101011111011101100000000001016110000000001101010113111111011101010101010101",
    "10100010100000101000101010001000001000100000000000001010000000000000001010001000001000001010101010001",
    "10101010101110101010601010101111103110111100000000011010110000000000113011101011101111111010101011111",
    "10101000100010101010101000101000101000001000000000000010000000000000001000100010001010001010106010001",
    "10111111111011101011101011111010101011111000000000001111110000000001101110111110113010101010111010111",
    "10001000001000101010001010000010101010000000000000001000000000000000101010000010001010100010100010001",
    "11101011101110101010011010111110101010111110110010101011110000000001101010111111101010111110101111101",
    "10101010100010000010100010000010001010100000001010101010000000000000001010100000001010001010100010001",
    "10101010161011111110311111111011111010101111111010101011161111111131111010101116111011101010111010101",
    "10101010001000000010100000600010000010101000100010600060000000100010100000100010001000000010000000101",
    "10101011101111111010101010101111111110101110101111111010111110101010101111111010101111111111101111101",
    "10100010000000100010101010101000000000101000100000001060001010001010100010001000101000000400101000101",
    "10111110111010101110101011101011113111101010111111101011101011111010111010101111101011111010101010111",
    "10001000001010100010001000100010001000000010000000100010001000001010001010100000100010001010101010001",
    "10101111101010111010111110111110101011111111101111111010111010111010101011101110111110101010101011101",
    "10100000101000001010000000000000001010100010001000001010100010000010101000100010100000101010101000101",
    "10111110101111111011111000000000001010101011101011101010101111111011101110111010101116101110111110101",
    "10000010101000001010000000000000000010101000101010001010100000000000100000000010100000100010000010101",
    "10111010101011101010111000000000001110101110111010111110111100000000100000001110111110111011101110101",
    "10001010101010001000101000000000001000100010000010006000100000000000000000001010100010001000100010101",
    "10111010101010011111101000000000001110111011111111101011101000000000100000011010101011101110101010101",
    "10100010001010000000001000000000000010001000000010001000001000000000000000000010101000101000101010101",
    "11101031111011111111101000000000001010101111111010111011113111101011100000011010101010101011111010101",
    "10001010001010001000001010001010000010601000101060101010000000100000100000001010601010101010001000101",
    "10113110101010101011111000000000000010101010101010101011101111101110100000001110111000000000101111101",
    "10000000101010101000001000000000000000100060001010100000001000100010000000000000000000000000101000101",
    "10111111101010101111101000000000000111111111111010111111111010111031100000011111111000000000101010101",
    "10001000101010100000100000000000000000100000000010100000100010000010000000001000000000000000000010001",
    "11111010101011101110111000000000000110101111111110101110101111111111100004001011111000000000111111101",
    "10000010001000101000001000000000000010001000001000101000001000000000000000000010001000000000001010001",
    "10111116101110113011101000000000000031110011101011101111111011110000000000000010111110111110101010111",
    "10100000000010001000101040000000000010000010001000100000001000100000000000000000000000000010101010001",
    "10111111161111101110111000000000000010101111111110111111101110100000000000000400000000000011101011101",
    "10100000100000100000000000000000000000100000000010000000001010000000000000000000000000000000001000001",
    "10101110101110111010111000000000000116111111101111611111111011100000000000000000000000000011111011111",
    "10000010000010001010100000000000000000000000100000000000100000100000000000000040000000000000001010001",
    "10111111111111101011101611111111111116111110161111101110111010100000000000000000000110100001111010101",
    "10100000000000001000100000000010000000001000100000101010100010100000000000000000000000101010000010101",
    "10101111111111101110111111101010101111101010101011101010101011110000000000000000000111101010111110111",
    "10100010000000100004000000101010101000000010101000101000001010000000000000000000000000101010000010001",
    "10111011111010100000000000101010101161111110111010101111111010100000000000000000000110101111111011101",
    "10001060001010000000000000001010101000100000001010101000001010100010000000000000000010101000001000001",
    "11101010101131100000000000111010101010111111101110101011101110311110111010111011111011101011101111101",
    "10001000100000000000000000100010101010000000101000101000100000101000001010001010001000001010100000101",
    "11111111101111100000000000101110101011111110101010101110111111101010111010101010101011111010111110101",
    "10000000100000000000000000100010100000100000101010100010100000006010100010100010101010001000000010001",
    "10111110111111100000000000111011110111101111101010111010101011111010101110101110101110101111111011111",
    "10100010000000100000000000100010000010001000000010001000101010000010100010106000100000100010001000101",
    "10101011111110100000000000101100111010111011111011111111111010111011101110111011111111101110101110101",
    "10101010000000000000000000600000101000101000100000000000001010100010001000100010000010100000100010001",
    "10101010111111161011111110111111101111301110101111111110101010111110111011101111101010111111301011101",
    "10001010100000100000000000100010000000100010101000100010101010100000101010001000001000000010101000101",
    "10113011101110111111111111101010111011101010111010101010101010100111101010111110111111111010101111101",
    "10001000000010000000000000001000001000001000000010001000100010000000001000000000100000000000100000001",
    "11111111111111111111111111111111111111111111111111111111111111111111111111111111111111111111111111111"
  ]
}
