{
  "id": "level6",
  "name": "Level 6 — The Void",
  "legend": {
    "0": "empty",
    "1": "wall",
    "3": "window",
    "4": "stand",
    "6": "door"
  },
  "audio": {
    "music": {
      "src": "/audio/music/level_6.wav",
      "loop": true,
      "volume": 0.5
    }
  },
  "colors": {
    "ceiling": "#0c0c12",
    "floor": "#1a1a1c"
  },
  "spawn": {
    "x": 2.5,
    "y": 1.5,
    "rot": -1.5
  },
  "rows": [
    "11111111111111111111111111111111111111111111111111111111111111111111111111111111111111111111111111111",
    "10000000000010001000000010001000000010000000000010000010000000000000000000000010000010000000001000001",
    "11111111111010101011111110101011101110111111101110101110111111111010111111111010011010111111101010111",
    "10000000001000106000000000100000100000101000001000100000100010001010001000001000101010000010001010001",
    "10101111113111101011111011116111111110101016106011111111101110101011101111101111101011101001111011101",
    "10100010000000101010000000000010000010001000101010000000001000101000100010001000001000101000001010101",
    "11111010111011101110111111311010111011101110101011111110101011101111111010111011101110101111101010101",
    "10000010001000001000100000101000000010001000101000000010101010000000001060000000100010101000101010101",
    "10111111101111111011101110103111101110011011101111111010101011111111101010111111101110101110101010101",
    "10000000100000100010001010001000101000001010101000000010101000001000100010100010001000100000101000101",
    "11111010111110101111101011101010101011111010101010111110101111101010111110101110111011111110101110101",
    "10000010000010001000001010000010101010100010000010101000100000101010000010001000100010000010100000101",
    "10111131111011111011111010111111101010101130111110101011101110101010101010111010101111101010111111101",
    "10001000001000000010000010100000001000100010001000100000100010101010001000100010140000006010100000001",
    "11101011111011611110101110101111111111111016111011101111111010101110111111101111101111111011101111101",
    "10001000100000000010100000100000000000001010000000000000000010100010001000101000001000101000101000101",
    "10111110101111111010100000000000111111101010111000000000011110111010111010101011111010101110000011101",
    "10000010101000100010100000000004000000101010100000000000000010100010100010000000000010600010000000001",
    "10111010101010101130000000000000111011101010101000000000011011101110101111100000001110101010000011111",
    "10100010100010100010100000000000001010001010100000004000001010001000106000000000001000101000000000101",
    "11101100113110111010111110111010101110111010101000000000011010111110101011100000001011101611000010101",
    "10001000001000001000100010101000100000101000101010100000100010000010100010000000001010601000000010101",
    "10111011101011111110101110101111111111101011111010161111101016111010111110100000000010101161000010101",
    "10001000101010000010001000100000001000001010000010100010001000001010000010100000001010100000040000101",
    "11101010111010111011611011101111101110101010111110111060111110111011101110101111111010111111000011101",
    "10001010000010001000001000001000101000101010100000000010001000600010000010000010000010000010000010001",
    "10111111111111101111101161111110101011311010101111111016101011101010111011111010111111111010111111101",
    "10001000000000001000100000000000101000000010001000001000101000101010101000000010100000001010100010001",
    "11101011111111111010111011101161101011111111111011101111101011101110101111111610001111101010101010111",
    "10001000001000100010000010001000001000001000000010101000001010001000100010001010100000100010001010001",
    "10113110101110101111111111111011111111101011111110101011113010111011100010101010101110111111111010101",
    "10000000100010100000000000001010001000101010000000101000001010001000001000100010100010000000001010001",
    "10111010111010113161111111101010101010101010111110101111101111101110111111111110111011111111101010101",
    "10101010001000001000100010100010100010100010000010000000100000100000100010001000100000001000101010101",
    "10101011111111101010101010111110111110111111111011111110111011111131101010101011111111111010101010101",
    "10001000000000000000001000001000100010000000100010000010001010000010001000101000001000100010001010101",
    "11111000000000000001100000101011311011111110111110111011101010111010111111101111101010101111111010111",
    "10000000000000000000000000101000001000000010000000101010001060001000100000100000000000000010000010001",
    "10111000000000000000100000103111101111101111111111101010101011101111101110111111000000001010111111101",
    "10001000000000000000100000101000100000100000000010000010001000100000101000000010000000001010100000001",
    "11101000000000000001100000101010111610000010116110111111101110113110101011111110000000001010101110101",
    "10001000000000000000100000001010001000000010100000100000100000001010001000000000000000000010101000101",
    "10111110101111111010100000111011101010000011101111101110111111101001101111111611000000001010111011111",
    "10000000100000000010000000000000100010000000001000000010001000001000100000100000000000000010001010001",
    "10111111111011111111100000111110111110000011111011111011101011111110111110101110000000001111101010101",
    "10001000001000000010001000001000101000000000001000101010001010000000100010101000000000001000001000101",
    "11101011101011111011101111111011101010000010101110101011101010111110101010101161000000001011111110101",
    "10101010101010001000100000100010001000100000101000001000101010001000001010100000000000000010000000101",
    "10101010101010111610111110101110111110101111111011111110111010101111111130111111111111111010111110101",
    "10101010001000100000100010001000100010101000000010000000100010100000000010000000000000001010001000101",
    "10101010111111101111101111111010101010101011111110111011101110111000011011111111311111101011100010101",
    "10001010000000101000001000000010101000100010001000100010001000001000001000001000100000006000001000101",
    "10111011111110101011101011111110101111101110101016101110111111101000001110001010101111111111611110101",
    "10600010000010001010001010100010100000101000100010101010000010000000000010101010101060001000001000101",
    "10111010100111111011111010101010111110100400001110101011111011111000011010101110101010101011101011101",
    "10100010100000000000000000101010000010000000001000100000001000001000000010100010101000101000101010001",
    "10101110111111111011111110106010111011100000401110111111101111101000011010111010101111101110101010101",
    "10101010000010001000100010101010101000100000000010100000001000100000000010100010100000100000000000101",
    "10101010111110101111101011101010101110100000001010101111111110111000011110101610116110111111111011111",
    "10001010100000100000001000006000100000100000000010100010000000101010000010100000000000001000001010001",
    "11111000101111111111111111111111101111100000001110111011111010101001111110100000000001101011101010101",
    "10000010100000100000000000001000001010000000000000001000100010001000000000100000000000001010101010101",
    "10111010111110101000000000111011111010100000000000001110101131101611111131100000000000101010101110101",
    "10101010100010100000000000001000100010100000000000000010101000101000000010001000101000601000100000101",
    "10101010101110111000000000101110101010100000000000001110101011101110101110111010111011101110111111101",
    "10001000001000101000000000100000101010100000000000001000101010000000101000100010100010000010000010101",
    "11101100000011101000000000111111101110101010101110111011101010111111111011111110101111100111111060101",
    "10000000000010001000000000000000001004101010600010000010001000101000001000000000100000101000001010101",
    "10111100000110101010111010111010111010101010111011111110111011101011101611101111111110101011101010101",
    "10006000000010000010600010100010100010001010000000000000100000001010100000101000000000101010100010101",
    "11101000000010111110101111101111101110111011111111111011111111101010111011100011111111101010111110101",
    "10001000000010100010001000100000101010101000000010001010000010101010001000001010000000001000000004101",
    "11111010111110101111111010111110101010101111111010101010111010101011101111111011111111111131111110101",
    "10000010000000100000100010000000101000000000000000101010001010001000100000001010001000000010000010101",
    "10111111111011111010111011101111101111000000000000101110111011113110111110101010101011311010111010101",
    "10001000001000001010001000101000100010000000000000101000100010000000000000101000101010100010001000101",
    "10101011101111101011101110111010161010000000000001101011101010111111111111111110101010101111101111101",
    "10101010001000101000100010001010100010000000000000100010001010001000001004000010101000100000000010001",
    "10101010111011101010111010101010101110000000400000111110101110161011101010111010103110111111111010111",
    "10101010100000101010100010100010100010000000000000000000101000100010000010001010101000001000001010001",
    "11106010111110101610101111111110111010101010101011111111111011101131111110101010101011111011100011101",
    "10001010000010000000100000100000100010101010101000100000000010001000100000100010100000100010101000101",
    "10101011111011111161111110101110101110101010101110101111111110111010111111101131111111101110103111101",
    "10101000001000100000000010101010100010001010100010000010000010100010000000100000000000001000101000001",
    "10311111101110101110000000000010161011113010111011111110111010101116161110111111111111111011101011101",
    "10100000100010101000000000000000001000001010001000001000101010000010000000100000000000000010001000101",
    "10101110110010103110000000000011101111101011111111101011101011111010111111101131111111111010111010111",
    "10001000001010001000000000000010000000101000000010001010000010001010101000101010001000001000100010001",
    "10111010111011111010000000000011111111101011111010161010111110101110101010101010106010101111111131101",
    "10100010100010000010000000000010001000101010001010100010000010100010100010001000101010100000001000001",
    "10101111101111101110000000000010101010101011101010101111111010111010111011111111101010111111101011101",
    "10600000006000101000000000000000101010001000001000100010001010001010000000001000100010000000101000101",
    "10113111111010101010000000000010101011111110113111311010101010101010101111101000111011111110101110001",
    "10001000000010100010100010000000101010000010100000000010100010101010100010100010001000100000100060101",
    "11101111101010101110101110111111101010111010101111111110111111101010111010111110101111101111111010101",
    "10100000101010101000101000100010100010001010101000001000100000001010100010000000100000000000100010101",
    "10111110101060111016101011101010111111101010101011101001311010111011100110101111100000000010101110111",
    "10001000101010100010001000001000100000101000101000100010001060101000001010101000100000000010100010001",
    "10101011111010101010111111111110111010111111101110111110101110101111111010101010110000000110111011101",
    "10100000000010001010000000000000000010000000001000000000100000100000000000100010000000000010000000001",
    "11111111111111111111111111111111111111111111111111111111111111111111111111111111111111111111111111111"
  ]
}
