{
  "id": "level5",
  "name": "Level 5",
  "legend": {
    "0": "empty",
    "1": "wall",
    "3": "window",
    "4": "stand",
    "6": "door"
  },
  "colors": {
    "ceiling": "#243047",
    "floor": "#26211d"
  },
  "spawn": {
    "x": 2.5,
    "y": 2.5,
    "rot": 0.3
  },
  "rows": [
    "11111111111111111111111111111111",
    "10000000000000000000000000000001",
    "10016111111411110111411111111001",
    "10010000000000010000000000001001",
    "10010111111111011111111611101001",
    "10010100000006000000000000401001",
    "10010101111101111611146110104001",
    "10000001000000000000000000001001",
    "10116101114111111111141414111001",
    "10000001000000000000000000001001",
    "10060101111101611111161140101001",
    "10010100000001000000000000101001",
    "10010116111111011111611111401001",
    "10010000000000010000000000001001",
    "10011116114461110111111111111001",
    "10000000000000000000000000000001",
    "10011611161114141111114111411001",
    "10010000000000000000000000001001",
    "10041114111116111111411111111001",
    "10000000000000000000000000000001",
    "10000000000000000000000000000001",
    "10000000000000000000000000000001",
    "10000000000000000000000000000001",
    "11111111111111111111111111111111"
  ]
}
