{
  "id": "level1",
  "name": "Level 1 — Beige Halls",
  "legend": {
    "0": "empty",
    "1": "wall",
    "3": "window",
    "4": "stand",
    "6": "door"
  },
  "audio": {
    "music": {
      "src": "/audio/music/level_1.wav",
      "loop": true,
      "volume": 0.5
    }
  },
  "colors": {
    "ceiling": "#0c0c12",
    "floor": "#1a1a1c"
  },
  "spawn": {
    "x": 2.5,
    "y": 1.5,
    "rot": 0
  },
  "rows": [
    "11111111111111111111111111111111111111111111111111111111111111111111111111111111111111111111111111111",
    "10001000100000000010000000001000000000100000001010000010000000000010001000100000001000100000001000001",
    "11101010101011111010111011111011111010101011101010101110111110111010101010101110101010101111101010111",
    "10001010001010001010000000000010001010101010001000100000001000000000400060101000101010101010001010001",
    "10111111101010101010000001111110101110101010111110011611111000000000001110111011101010101010111111101",
    "10000000101000101000000000001000100000101010000010000010001000000000000010100010101010001000100000001",
    "11111110101111101110000001101011111111101011111011111010101100000000001010101110101010113011101111101",
    "10000010101000100000000000001000000000001010001010001010100000000010001010001000100010001010001000001",
    "10101110111010101110000400111131111111111011101010111010111111111110101011111010101110111011101111111",
    "10101000100010100010000000100010000000000010001010000010100000100000100000100010001000001000100060001",
    "11101011101110111010000001101110111111111110111011111010000010111011111110101011111011101110101010101",
    "10000000001010001010000000001000100000000010000010001010000010001000001000101000001010001000101000101",
    "10000011111011101010000001101011101111111010111110101110000011101111101011101111001010111011311111101",
    "10000000001000101000000000001000000000100010100000100010000010001000101010001000001010001000000000101",
    "10000011101011101111111131101611111111101110100110111011000010111010101110111011111011101111611110101",
    "10000010001000600000001010001010000000100010101000101010000010000060100060101000100000100010000000101",
    "11000010161110111111101010111010111110111010111011101011000011111010111010101110101111101010111111101",
    "10000010000000006000101000001010001060000010000010001000000000001010001000100010001000001010000000101",
    "10000011111111101010101111101011101011111111111111101111000011101111101110101011111011111011111110101",
    "10000010001000100010101000101010001000000010001000001000000000100000100010101010001010000010000010101",
    "10000010101010111111101010101010111011111010101010161011000010111110111010101010101011101110111010101",
    "10000010100010000000001010101010100010000010100010100010100010000000001010001010101000100000001000601",
    "10000010111000000000001010101010101110111110111111101110011111111010101011111010111110111011101111101",
    "10100010000000000000000010100010101000001000001000101000001000001000001010001010100010101010101000001",
    "10101111161000000000001110111130101111101111101010101011101161101111111010101010001010101010101011101",
    "10101000001000000000000010000010100010000000101010001000100000100000000010101000101000100000101010001",
    "10111010111011101110111011111010111011111110101011111100311110101111101110111011101111101111101010111",
    "10100010000010001010000010001010001010001000101010000010100000101000001010000010001000100010001060001",
    "10101111111100111011111110101031101010101110101010111010101116111011611010111110111011101110111011111",
    "10100010000000101000000010100010001000100000001010100010100000001010000010000010001010001000100000001",
    "10111011311011101011111010111110111011110011101010111010101161101010111016101131101010013011111011101",
    "10001000100010001000101000100000100000001010001060001010101000100000100000101000101010001010001010001",
    "11101110101110101110103111101016111111111011111011101010111010111110111111101010101011101010101010111",
    "10001000101000100010101000001010000000001010000010001000100010000010100000001010001000006000101010001",
    "10101011101011101110101010111010111111101010011110111110101111111010101111111010111111111111101131101",
    "10101000001000001000100010100010001000101010000010001000100010000010001000000010100010001000100000101",
    "10111111111010101011111130111111101010101011111010101010111010011110111011111011101010101010111110101",
    "10000000100010101000000010000000101010001000001010101010000010101000100010000010001000100010000010101",
    "10111010101110011111111010111110101011161011111011101010111110101011301011111110111111111110111110101",
    "10000010001010001000000010100010001000001000000000001010601000100000101010000010100000100010000010001",
    "11111011311011101011111110111011111111101110111111101110101011111011101110111060101011101011611011101",
    "10001000100000101010000010000400100000100010000010000000001000001010001000001010101060001000001000101",
    "11101110101111101010111111111110111010111010111110111111111110101010161011111010101110111110111110101",
    "10001010101000001060001000000060000010001010100000000010000010101010000000100010100000000010000010001",
    "10101010101011101010101011111011111011101010100000000000110011001011111110101010101111116111111011111",
    "10101010101000101010100010001010000000101010100000000000101000001010000010101010101010000000100000101",
    "10101010101110111011111011001010111110101011100000000000101111113110111010101130101010111110101110101",
    "10100010100010001000001000001000400000000000000000000000001000000000101010100010100010100010001010001",
    "10111110101111101116101111101100000000000011101110111011001011101111301010111010111010111011311011101",
    "10100010100000100010001010001000000000000000100000001000101010100000100010001010100010001000100000001",
    "10000000111010101610011010111000000000000011111011111110101010111110101111311010111110101110101111111",
    "10000000000010101000100010100000000000000000001010000010101000100010100000100010000010101000100010001",
    "10000000111111101011101010101100000000000001101110111010101110111010111110101011111010101011111010101",
    "10000000100000001010101000100000004000000000000000100010100000000010100010001010001010101010001000101",
    "10000000101110111010101111111100000000000010111111101110111111111010101011111010111010101010101111101",
    "10000000100010100010100060000000000000000010001000100010000000100010101000000000100010601000100000001",
    "10000000111010101110110010111000000000000010111010111010101010111110101000000000101111101011111111111",
    "10000000000010101000000000101010001010001010100010100010100010100000101000000000100000001010000000001",
    "10000000111011101001111116101010111011111011101110111011111110101111101000000001111111113011111010101",
    "10000000100010001010001000100010100010001000100010001000000000100000001000000000000000001000001010101",
    "10111110111110111011101010111060101110101110111011101111111111111111111000000040111111101111101110101",
    "10100010100000101000001010001010100060100010001000100000100000000000100000000000000000101000101000101",
    "10101010000000000001101011106010111010111010111110113110101111311110101000000001111010101010101011101",
    "10001010000000000000001000101060100010001010000000001000101000100000100010000000001000100010100010001",
    "11111010000000000001111110101010101111111011111111111011101010101111111010110000000001111110111110111",
    "10001010000000000000001010101000100000100000000000000010001010000010000060000000000000001000001000101",
    "10101010000000000000101010101111111110101100000000001110101111111010111011100000000001101011111001101",
    "10101000000000000000101010100010000010001000000000001000100000001000100010000000000000001000000010001",
    "10101110000000000001101010111010111011111000000000001011111111101111101110110000000001111111111110111",
    "10101000000000000000100010100010101000001000000000000010100000001000106000100000000000100000100010001",
    "10101010000000000001111010101110101110111000000000001010001110111010101011101011101110101110101011101",
    "10101000000000000000001010101000100010000000000000001060101000100010101010001000100010100010001010001",
    "10113110000000000000101010101110101011111100040000001010101111101110111010111111311010100011111010101",
    "10000010000000000000600010100010001010001000000000001000101000101010100010100000001000101000001000101",
    "10111010101110101010111110111011111110101000000000001110101010101010101110101000000111311111101111101",
    "10100010001000101010101000100000000000000000000000000000100010000010100010000000000000000010001010001",
    "11101111111011311010101011111111100000000000040000001111311011311010111010111000000111111010111010111",
    "10001000001000001000000000000000600000000000100000100000000000101000001010100000000000001010100010001",
    "10111010111111101111111011111110100000000110111110101111101110106011101010101000000011111010101111101",
    "10001010000000101000001010000010000000000010000010001000001000001010006010101000000010000010100000001",
    "11101011111110101011101011111016100000000010111111101016111111311010111010101000000010111110111011111",
    "10001000100010100010001000000010000000000010100000101010000000100010100010100000000010100010001010001",
    "10101110111010111610111111111110100040000010101110111010101110101011101110111000000110111010101011101",
    "10100010000010000010000000000000600000000000000010000010101010101010001000100000000060001000101000001",
    "10111111111010111011111111111111100000001111101011111110101010001110111111101110111011001011101111101",
    "10000000000010101010000000100000000000000000106000000010101010101000100000600010001010001010001000101",
    "10111111111110101010101111101610100000001110101010101011101010101011111010111011111010111010111010101",
    "10000000100010100010100000001000604000001000101010001000001000001000000010000010000010001010100010001",
    "11111011101010101110111111111010111010111011101110161011111111101111111111111110111111101010101111111",
    "10100010001000101000100000001010100010000010000010001010000000100000001000100000100010001010100000001",
    "10101130101110000000000000001011101111111100000000103110111110161111101010101110101010111100101011101",
    "10000010101000000000000000001000001000000000000000001000101000100000101010101010001010100000601000101",
    "11111110111010000000000000001111313111101000000000111011101011101110101011101031111010101111101111101",
    "10000000100010000000000000000010100000001000000000000010001000100010001010001010000010006000100000001",
    "10111110101110000000000000001010101011111100000000111110111110111110111010111010111111111010111111101",
    "10000010100010000000000000001010001010000000000000100010000010000010000010001010000000001010000010001",
    "11111010111010111111101111101011111010101000000000101010101011111011111111101011111111101011111010111",
    "10000010100010000000101000001010000010101000000000101000101000101000001000001000100000001010000010101",
    "10111111101111111011101110111010111110101110111010111111101110101111101011111110101111111010111110101",
    "10000000000000001000000000000000100000100000001000000000001000000000100000000000100000000000000000001",
    "11111111111111111111111111111111111111111111111111111111111111111111111111111111111111111111111111111"
  ]
}
