{
  "id": "level3",
  "name": "Level 3",
  "legend": {
    "0": "empty",
    "1": "wall",
    "3": "window",
    "4": "stand",
    "6": "door"
  },
  "colors": {
    "ceiling": "#30314a",
    "floor": "#252022"
  },
  "spawn": {
    "x": 2.5,
    "y": 2.5,
    "rot": -1
  },
  "rows": [
    "11111111111111111111111111111111",
    "10000000000000000000000000000001",
    "10016111101411111111410111111001",
    "10010000001000000000001000001001",
    "10010111111011111111111011101001",
    "10010100000040000000000000401001",
    "10010101111110111611146110104001",
    "10000001000000000000000000001001",
    "10116111114111110111141414111001",
    "10000000000000040000000000000001",
    "10061141111141011111161141141001",
    "10010000000001000000000000001001",
    "10010116111101111111611111401001",
    "10010100000000000000000000101001",
    "10010106114461111111111110101001",
    "10000001000000000000000000004001",
    "10111601161114141111114111411001",
    "10000000000000000000000000000001",
    "10041114111116111111411111111001",
    "10040000000000000000000000004001",
    "10011114611111411111411461161001",
    "10000000000000000000000000000001",
    "10000000000000000000000000000001",
    "11111111111111111111111111111111"
  ]
}
