{
  "id": "level5",
  "name": "Level 5 — Crimson Wing",
  "legend": {
    "0": "empty",
    "1": "wall",
    "3": "window",
    "4": "stand",
    "6": "door"
  },
  "audio": {
    "music": {
      "src": "/audio/music/level_5.wav",
      "loop": true,
      "volume": 0.5
    }
  },
  "colors": {
    "ceiling": "#4a1818",
    "floor": "#1a0a0a"
  },
  "spawn": {
    "x": 3.5,
    "y": 1.5,
    "rot": 0.4
  },
  "rows": [
    "11111111111111111111111111111111111111111111111111111111111111111111111111111111111111111111111111111",
    "10100000001000000010001010000010001000100000000010001000001000000000001000100000000000100000001000001",
    "10101111101011111010101010101010101110101111111010000000001111111110101010101110161110101111101011101",
    "10001000101000001000101000101000100010001000001000000000000000000010100010000000100000100010600010001",
    "11611010101111101111101011101111111010111011101111400000011111111010111111111011311011111010111110111",
    "10000010100000001010001000101000100010100010001000000000000000001010001000001000001000100010001010001",
    "10111110111111311010111011001401101110101130111010000000001110111011101011101011101110101110101011101",
    "10001010100000100000100010001000100010101010000010000000001000100010001010100010001004001000101000101",
    "11101010111010101111111110161110111010101011111110000000001011101110110010111010113111111110101011101",
    "10001000001000101000000000100000101010106000101000000000001000001000000010000010000000100000101000101",
    "10111611101110101011111111101110101011101010101011000000013110111611111111111111101110111011101110601",
    "10000000100000100010100000001010101000001010001000000000000010100000001000000000100010001010000000101",
    "10113110101111111110101011111010101100000011101111111010101010101111106011111110111111101011101111101",
    "10001000101000100000001010000010000000000010101000001010001010101010001000100010100000001000101000001",
    "11111010111010101111111010111011111000000010101010101010111010000000011110101010101110001110111011111",
    "10000010100010000010000010001000000000000410001010101000000000000000000000000000101000100010100000001",
    "10111111101111111010111111111111111100000010111010113000000000000000001000000000101110111010101111111",
    "10000000001000100010001000000000000000000010001010001000000000000000001000000000100010001010000000001",
    "10111111101010111111101011111161111000000031101111101000000000000000001000000000111011101010111011101",
    "10001000101010000000001000100000001000000010100010001000000000001010001000000000100010000010100010001",
    "11111010111010111111101110101111101000000010111010111000000000001011111000000000000000011110101110101",
    "10001010000010100010101010100010001000000010000010000000000000000000100000000000000000000010100010101",
    "10101011111111101010101010111011101111111010111131101011101011111131101000000000000000000000000010101",
    "10100010001000001010100010001000100000000010001000001000101010000010001000000000000000000000000010601",
    "10111110101011111010101011101110101111111131101011111110101110111010111000000000000000000000000110101",
    "10000000100000100010001000001010101000001000000060001000001000100010001000100004000000000000000010101",
    "10111111111111101110111011111010311011101111111110101111101011101011101111161100000000000000000110101",
    "10100000000010001000101010100010100010001000000000100000101010101000101000000000000000000000000000001",
    "10101610111010111000001010101010101110111011611111111110101010101111101010111100000000000000000011111",
    "10100010001010100000001010006010001010000010000010000010101010100000001010001000000000000000000000001",
    "10111016101060111000011010111011111011111111101011111010101010111111111011101400000000000000000111101",
    "10100060001010000000000010100000000000001000001000000010101000001000001010100010000000000000000010001",
    "10111110111011000000000010101111111111101011113111111010111111106011101010111110111011101011111000111",
    "10000000100010000000000000101000101000001010000000001010000000101000101010000000100000106000001010001",
    "11111111301110000000000011101010101011111011111111101011111011101010111010101111111110101011101011101",
    "10100000101000000000000000101010101000000010000000001000100010001010001010101000001000001000100010001",
    "10101011101011000000000010101010101611111110111611103110101110111111101010101011101011111111111110111",
    "10001010001000001010100010100010100000000000100000001000100010000000100010100000101010100000000010001",
    "10111010111111101010101016111010111011111110000000000011111011111110101111111111101000000011111011101",
    "10001010001000000000001000001010001000001000000000000010100000000010101000000010001000000010001000001",
    "11101011101011111111111116101011101111101000000000000010101111111010101011011010111100000010101111101",
    "10001010001000000010000000101000101000001000000000000000100010100010101010000010001000000060100000101",
    "10111010111111111010111110101111101016111000000000000011110010101110101010111111101000000011101111101",
    "10100010100000100010001000101000001000100000000010001000001010006000100010000000101000000000100000001",
    "10101110101110101111111000101011111110101100001011111161101011101011111111110110101000000010101111111",
    "10100010001010001000000010100010000010100000001000001000001000101000000000000010000000000060100000001",
    "10111011111011111011111110111110111010111000001111101011101110101111111111111010000000000010111111101",
    "10001010000000000010600010101000001010100000000060001010001000100010000010000010000000000000101000001",
    "11101010111110111110101010101016111010111100001010111010111011111010101130111110000000000011101011111",
    "10101000001000100000101000100000100010001000000010000060101010001010100010100000000000000010000010001",
    "10101111111011311110101111101110101011101100001111111110101010101110111010101010000000000010111110101",
    "10001010001000001000101000000000101000001000000000100000001000100010100010100010000000000010101000101",
    "10111010101111101011101010111011101110111011161010101111111111111010101110111010101111101130101011101",
    "10100010101000001000001010001000100000100000100010101000100000001000100010001010101000100010000000101",
    "10101110101011111011110031101110111111101110101110111010101011101161111011101010101010111010111111101",
    "10100010600010001000100010001000100000101010100010100010001000100000006000100010101010001010100000101",
    "10111010111110101110101110111011111010101010111010101111111110101111111010111110101011101010101110101",
    "10100010100010100000101000100010001010001010001010001000000010101000000010000010001010001010100010001",
    "10101010101110111111111011101110101111001011106011111116101110111011101131111011111011101010161011101",
    "10001010100000000000001000101000101000100010101000000000001000100010001000100010001000100010100010101",
    "11111010100000001011101110101010101010111010101111101111101011101011111010101110101110311010101110101",
    "10000010100000001010001000101010101010100010100000101000101000101010000010100000100000100010101000001",
    "10161110110000001011100000000000001010101110111110101010111110101110111110111111311111101110101011111",
    "10000010100000001000140000000000000010101000001010001010100010100000100010000010000000000010101010001",
    "11111110100000001110100000000000011110101011101011111010101010111111111011111011101111111010101010111",
    "10000000100000000000100000000000000010100010001010001010001010000000000000101000100010001010001010001",
    "10116111100000001111100000000000011110110110111010101011111060111111111110101110161010101111113011101",
    "10100000100000000000000000000000000000100010000000100010000010000000000010001010101010100000001010001",
    "10101111100000001111110000000000001111101011111010111110111110110111111011101010101010111011111010101",
    "10100000000000000010001000000010100010001000000010001010100010100000100010000010100010000010001010101",
    "10111111111011111010101000111110111011101111111111101010101110101011101111111110101110101110101010101",
    "10000010001010001010101000001000001000101000000010001000100010001010001000100000100010101000100010101",
    "11111010101610101010103110101011111110111011111010111011111010000000000000101111111010101011111110101",
    "10000010101000101000101000001000100010000010001010100000001000000000000000101000100010100010000000101",
    "10111010101011101111101110111110101011111110111010101111101010000000000000101010101110111110111111101",
    "10100010100000101000000010100010001000000000100010000010101000000000000000001010101010100000100010001",
    "10161010111111101111111011101011113011311110101111111060101110000000004001111010101010101161101010111",
    "10001010101000101000006000001010001010100000100000000010101000001010000000100010001010001000001000101",
    "11101110101010101011101111111010101010101111111161111110101011101011111010111110111011111011011111101",
    "10001000001010001010100000100000100010001000100000000000100010101000000010100010001000001010000000001",
    "10111011111011101010111110111111111111101010101611111110111110101111101010101011101111101011101110101",
    "10001010100010001010000010001000000000100010000010001000100010101000001010001000100000101010001000001",
    "10101010101110113010111011101011000000000011111010101011301010101011111011161110111110101010111011111",
    "10100000101000101010001010000000000000000000000010101000101000101010001010000010100000001010001010001",
    "10111111101011101010101010111110000000000016101110101110101011101010111010111010111111111010101110101",
    "10000000100010001010101010000000000000000010001000100010001010001010001010100010000000100010100000101",
    "10111110101011101011101111111111000000400010111011111011111010111010101011101111111110101110111111101",
    "10100010101000101000100000100000100010001010100010100010000010100010000000000000000010001000000010001",
    "10111010103110101610111010011110111111101011101110101010111110111010000000000000101131111011111610111",
    "10001000001000100010001010001000000010101000001000101010100010001000000000000000100000000010000010001",
    "10101011111110001111101011101011111010101110111110101010111011101110000000000000111111111110111010101",
    "10101000100010001000001000100010100000100010100000101010000010100000000000000000000010000010100010101",
    "11101110101011111011113110111110101131111010101110101111111010311110000000000001101110111010101111001",
    "10001010101000001010000010000010100010000010001000100000100000100010000000400000001000001000600000001",
    "10111010103111101010111011111010111010111111101111111010101111101010000000000001111011101111111111101",
    "10001000101010001000101000100010100010001000101000001010000010001010001010100010001000100000001000101",
    "10101111101010101111101110101110101111101010111011101011111110161011111010111110101110101110111010101",
    "10100000001010601000000010001010001000101010001000101000100000100010000010100010600000100010001010001",
    "10161111111010111011111011111010113110101011101110001111101111101110111010101010111111111011001011111",
    "10000000000010000000001000000000000000100000100000100000000000100000001000001000100000000000100000001",
    "11111111111111111111111111111111111111111111111111111111111111111111111111111111111111111111111111111"
  ]
}
